.#.#...#.##..########.#.#####...#..##.##
#..##..##.##.#..#...###.#.....#.....##.#
##..#.#.##.#....##...#..#.####.####...#.
.#..#.##.#######.#.#.####.##.###...##.#.
###.#...#..#....##.#...#....#....#..#.#.
###...#.#..#.##....#...##.#..####.#...#.
.#.##...#.##.####.####..##.#.#..##.##..#
.#####..#.....###..#.#...#...#...######.
...####.###......#..####.##.###.#..##.##
.#..###.#####.#####.##.##.#..##..#...#..
.##..#....#.###..##...#.#..#.#.#..##...#
.....#..#.....#.....#..#####.#..#.#.####
.##.####.####.#..#####.##..#.###..###..#
.##.#..###....##.#..##..#..###.###...#..
.#..##.....##.##......#.#.#..#.....#..#.
.###.#.######.#####.#..##.#..#.###..#...
....##.##..#......##.#....#.##...###.###
..#......#.#..##.#.#..##..#...###..#.#..
#..##..#.#.#####.#.############.####....
###.##...###..#..##....#..#....#..#####.
#.#..##.#.....#.#.####....#.##........##
.######.#.##..#..#..#######.#####.##.#.#
.##...#.#####.##......#..#...#..####.##.
..#.#......##.#.##..#..#.##..#.#........
..##.#####.#..##.###.#.#..#.##.#.##..##.
...#.#..##.###.##..##..#.##....##.#####.
#..#.....##...#.##..#.##...##.#.##...#..
#######....##.##.#.##.#.###.#.##.#...#..
#.....#..#..#...##.#..###.#.#...###.####
#.##..###.#...#....#.....##..##..##.#..#
######..##.##..##.######.#.#...#.#..#..#
...#.#.#.######.#..#..##.##.####.######.
##..##.##..##.#.##........###..#...##.#.
#.#......#..###.#####.##.......#....####
#..##..#..#..#....#.#########.#####..###
###.##..#..#.##.#......#..###.##...#....
#.#..###.#.##.##.#####.....#.....#.####.
.####..#.......###..#.###..#.####...###.
.##.#####..##.......#...#.##....#.......
...#..#.##.###..######..#...##.###..##.#